-1 -1 -1 -1 -1 -1 -1 -1 -1 -1 -1 -1 -1 -1 -1 -1 -1 -1 -1 -1 -1 -1 -1 -1 -1 -1 -1 -1 -1 -1 -1 -1 -1 -1 -1 -1 -1 -1 -1 -1 -1 -1 -1 -1 -1
-1  -8  -2  -8  -2  -8  4  4  4  4  4  4  -1  -2  -8  -2  4  4  -8  -2  -8  -2  4  4  4  -1  4  4  4  4  4  4  4  4  4  4  4  4  4  4 4 4 -1 -1 -1
-1  4  4  4  4  4  4  4  4  4  4  4  -1  4  4  4  4  4  4  4  4  4  4  4  4  -1  4  4  4  4  4  4  4  4  4  4  4  4  4  4 4 4 -1 -1 -1
-1 4  4  4  4  4  4  4  4  4  4  4  -1  4  4  4  4  4  4  4  4  4  4  4  4  -1  -2  -2  -2  -2  -8  -8  -8  -8  4  4  4  4  4  4 4 4 -1 -1 -1
-1 -1  -1  -1  -1  -1  -1  -1  -1  4  4  4  -1  4  4  4  -1  -1  -1  -1  -1  -1  4  4  4  -1  -1  -1  -1  -1  -1  -1  -1  -1  -1  -1  -1  -1  -1  4 4 4 -1 -1 -1
-1  4  -2  -2  -1  -2  -8  -2  -1  4  4  4  -1  4  4  4  -1  4  4  4  4  -1  4  4  -2  -1  4  4  4  4  4  4  4  4  4  4  4  4  -1  4 4 4 -1 -1 -1
-1  4  4  -2  -1  -2  4  4  -1  4  4  4  -1  -1  -1  -1  -1  4  4  4  4  -1  4  4  -2  -1  4  4  4  4  4  4  4  4  4  4  4  4  -1  4 4 4 -1 -1 -1
-1  4  4  -2  -1  -2  4  4  -1  4  4  4  4  4  4  4  4  4  4  4  4  -1  4  4  -2  -1  -1  -1  -1  -1  -1  -1  -1  4  4  4  4  4  -1  4 4 4 -1 -1 -1
-1  4  4  -2  -1  -2  4  4  -1  4  4  4  4  4  4  4  4  4  4  4  4  4  4  4  4  4  4  4  4  4  4  4  4  4  4  4  4  4  -1  4 4 4 -1 -1 -1
-1  4  4  4  -1  4  4  4  -1  4  4  4  4  4  4  4  4  4  4  4  4  4  4  4  4  4  4  4  4  4  4  4  4  4  4  4  4  4  4  4 4 4 -1 -1 -1
-1  4  4  4  -1  4  4  4  -1  4  4  4  -1  4  4  4  4  4  4  4  4  4  4  4  4  4  4  4  4  4  4  4  4  4  4  4  4  4  4  4 4 4 -1 -1 -1
-1  4  4  4  -1  4  4  -2  -1  4  4  4  -1  -1  -1  -1  -1  -1  -1  -1  -1  -1  -1  -1  4  -2  -1  -1  -1  -1  -1  -1  -1  -1  -1  4  4  4  4  4 4 -2 -1 -1 -1
-1  4  4  4  4  4  4  4  4  4  4  4  -1  4  4  4  4  4  4  4  4  4  4  -1  4  4  -1  4  4  -8  -1  4  4  4  -1  4  4  4  4  4 4 -2 -1 -1 -1
-1  4  4  4  4  4  4  4  4  4  4  4  -1  4  4  4  4  4  4  4  4  4  4  -1  4  4  -1  4  4  -2  -1  4  4  4  -1  4  4  4  4  4 4 -2 -1 -1 -1
-1  -2  4  4  4  4  4  4  4  4  4  4  -1  4  4  4  4  4  4  4  4  4  4  -1  4  4  -1  4  4  -2  -1  4  4  4  -1  -1  -1  -1  -1  4 4 -2 -1 -1 -1
-1  -1  -1  -1  -1  -1  -1  -1  -1  -1  -1  -1  -1  -1  -1  -1  -1  4  4  4  4  4  4  -1  4  -2  -1  4  4  4  -1  4  4  4  -1  4  4  4  -1  4 4 4 -1 -1 -1
-1  4  4  4  4  4  4  4  4  4  4  4  -8  -8  -8  -8  -8  4  4  4  4  4  4  4  4  4  4  4  4  4  4  4  4  4  4  4  4  4  -1  4 4 4 -1 -1 -1
-1  4  4  4  4  4  4  4  4  4  4  4  4  4  4  4  4  4  4  4  4  4  4  4  4  4  4  4  4  4  4  4  4  4  4  4  4  4  -1  4 4 4 -1 -1 -1
-1  -2  -2  -2  -2  -2  4  4  4  4  4  4  4  4  4  4  4  4  4  4  4  4  4  4  4  4  4  4  4  4  4  -2  -8  -8  -2  4  4  4  -1  4 4 4 -1 -1 -1
-1  -1  -1  -1  -1  -1  -1  -1  -1  -1  -1  -1  -1  -1  -1  -1  -1  -1  -1  -1  -1  -1  -1  -1  -1  -1  -1  -1  -1  -1  -1  -1  -1  -1  -1  -1  -1  -1  -1  -1 -1 -1 -1 -1 -1
